1111111111111111111
1E000000K0000000001
10000000000000000C1
1000000000000000001
1000000000000000001
1P000000C0000011111
1111111111111111111