111111111111111111
10E000000000C00001
10C000000C00000001
10P000C0C0C0000001
100000000000000K01
111111111111111111