111111111111111111
10E000000000000001
10C000000000000001
10P000000000000001
100000000000000K01
111111111111111111