111111111111111111
10E000000000C00001
10C010000C00000001
10P000000000c00001
111111111111111111