1111111
10E0001
10C0101
10P0001
1111111