111111111111111111
10E000000000C00001
10C010000C00000K01
10P000000000C00001
111111111111111111