11111111
1P000001
100000C1
1C000001
100000C1
100E00K1
11111111