111111111111111111111111111111
1000000000000P0000000000000001
100000000C00000000000000000001
100000000000000000000000000001
100000000000000000000000000001
10000000000000000C000000000001
100000000000000000000000000001
100000000000C0000000C000000001
100000000000000000000000000001
100000000000E00000000000000001
100000000000000000000000000001
100000000000000000000000000001
10000000000000000000K000000001
100000000000000000000000000001
111111111111111111111111111111