111111111111111111111111111111
100C0000P000000000000000011111
111111000C00001111111110011111
100000000000001111111110011111
100C00001111111111111110011111
100000001111111111111110011111
100000000000001111100000011111
10000000011100111110C011111111
10C0000001110C1111100011111111
1000000001110011111000000000E1
111111111111111111111111111111